MMMMMMMMMM
M        M
M11122   M
M11122   M
M       GM
MMMMMMMMMM