1111111111111111111111111111
1111111111111111111111111111
11                         1
11   S                     1
11                         1
11                         1
11                         1
111111111111111            1
111111111111111            1
11    3       3            1
11    3       3            1
11    3       3            1
11    3       3            1
11    3       3            1
11    3       3            1
11    3       3        G   1
1111111111111111111111111111
1111111111111111111111111111
1111111111111111111111111111